"";"date";"Year";"WeekNo";"total_covid_death";"male_covid_death";"female_covid_death";"NC_covid_death";"country";"Type"
"1";"18670";"2020";"11";"1";"0";"1";"0";"Sweden";"Gender"
"2";"18670";"2020";"11";"1";"0";"1";"0";"Sweden";"Gender"
"3";"18670";"2020";"11";"1";"1";"0";"0";"Sweden";"Gender"
"4";"18670";"2020";"11";"2";"1";"1";"0";"Sweden";"Gender"
"5";"18670";"2020";"12";"2";"1";"1";"0";"Sweden";"Gender"
"6";"18670";"2020";"12";"1";"1";"0";"0";"Sweden";"Gender"
"7";"18670";"2020";"12";"6";"4";"2";"0";"Sweden";"Gender"
"8";"18670";"2020";"12";"7";"3";"4";"0";"Sweden";"Gender"
"9";"18670";"2020";"12";"9";"5";"4";"0";"Sweden";"Gender"
"10";"18670";"2020";"12";"8";"6";"2";"0";"Sweden";"Gender"
"11";"18670";"2020";"12";"11";"6";"5";"0";"Sweden";"Gender"
"12";"18670";"2020";"13";"11";"7";"4";"0";"Sweden";"Gender"
"13";"18670";"2020";"13";"21";"10";"11";"0";"Sweden";"Gender"
"14";"18670";"2020";"13";"22";"15";"7";"0";"Sweden";"Gender"
"15";"18670";"2020";"13";"31";"17";"14";"0";"Sweden";"Gender"
"16";"18670";"2020";"13";"32";"21";"11";"0";"Sweden";"Gender"
"17";"18670";"2020";"13";"35";"21";"14";"0";"Sweden";"Gender"
"18";"18670";"2020";"13";"38";"24";"14";"0";"Sweden";"Gender"
"19";"18670";"2020";"14";"45";"25";"20";"0";"Sweden";"Gender"
"20";"18670";"2020";"14";"48";"26";"22";"0";"Sweden";"Gender"
"21";"18670";"2020";"14";"53";"40";"13";"0";"Sweden";"Gender"
"22";"18670";"2020";"14";"70";"46";"24";"0";"Sweden";"Gender"
"23";"18670";"2020";"14";"80";"45";"35";"0";"Sweden";"Gender"
"24";"18670";"2020";"14";"70";"36";"34";"0";"Sweden";"Gender"
"25";"18670";"2020";"14";"85";"53";"32";"0";"Sweden";"Gender"
"26";"18670";"2020";"15";"90";"57";"33";"0";"Sweden";"Gender"
"27";"18670";"2020";"15";"84";"35";"49";"0";"Sweden";"Gender"
"28";"18670";"2020";"15";"115";"69";"46";"0";"Sweden";"Gender"
"29";"18670";"2020";"15";"86";"41";"45";"0";"Sweden";"Gender"
"30";"18670";"2020";"15";"90";"56";"34";"0";"Sweden";"Gender"
"31";"18670";"2020";"15";"102";"50";"52";"0";"Sweden";"Gender"
"32";"18670";"2020";"15";"97";"57";"40";"0";"Sweden";"Gender"
"33";"18670";"2020";"16";"84";"45";"39";"0";"Sweden";"Gender"
"34";"18670";"2020";"16";"91";"48";"43";"0";"Sweden";"Gender"
"35";"18670";"2020";"16";"115";"57";"58";"0";"Sweden";"Gender"
"36";"18670";"2020";"16";"111";"66";"45";"0";"Sweden";"Gender"
"37";"18670";"2020";"16";"83";"52";"31";"0";"Sweden";"Gender"
"38";"18670";"2020";"16";"86";"50";"36";"0";"Sweden";"Gender"
"39";"18670";"2020";"16";"87";"54";"33";"0";"Sweden";"Gender"
"40";"18670";"2020";"17";"85";"50";"35";"0";"Sweden";"Gender"
"41";"18670";"2020";"17";"62";"25";"37";"0";"Sweden";"Gender"
"42";"18670";"2020";"17";"77";"41";"36";"0";"Sweden";"Gender"
"43";"18670";"2020";"17";"86";"47";"39";"0";"Sweden";"Gender"
"44";"18670";"2020";"17";"89";"52";"37";"0";"Sweden";"Gender"
"45";"18670";"2020";"17";"73";"39";"34";"0";"Sweden";"Gender"
"46";"18670";"2020";"17";"74";"39";"35";"0";"Sweden";"Gender"
"47";"18670";"2020";"18";"74";"45";"29";"0";"Sweden";"Gender"
"48";"18670";"2020";"18";"83";"49";"34";"0";"Sweden";"Gender"
"49";"18670";"2020";"18";"83";"53";"30";"0";"Sweden";"Gender"
"50";"18670";"2020";"18";"78";"37";"41";"0";"Sweden";"Gender"
"51";"18670";"2020";"18";"78";"38";"40";"0";"Sweden";"Gender"
"52";"18670";"2020";"18";"72";"40";"32";"0";"Sweden";"Gender"
"53";"18670";"2020";"18";"75";"44";"31";"0";"Sweden";"Gender"
"54";"18670";"2020";"19";"84";"39";"45";"0";"Sweden";"Gender"
"55";"18670";"2020";"19";"72";"45";"27";"0";"Sweden";"Gender"
"56";"18670";"2020";"19";"73";"42";"31";"0";"Sweden";"Gender"
"57";"18670";"2020";"19";"80";"41";"39";"0";"Sweden";"Gender"
"58";"18670";"2020";"19";"60";"30";"30";"0";"Sweden";"Gender"
"59";"18670";"2020";"19";"68";"34";"34";"0";"Sweden";"Gender"
"60";"18670";"2020";"19";"73";"31";"42";"0";"Sweden";"Gender"
"61";"18670";"2020";"20";"65";"32";"33";"0";"Sweden";"Gender"
"62";"18670";"2020";"20";"61";"32";"29";"0";"Sweden";"Gender"
"63";"18670";"2020";"20";"50";"24";"26";"0";"Sweden";"Gender"
"64";"18670";"2020";"20";"46";"21";"25";"0";"Sweden";"Gender"
"65";"18670";"2020";"20";"58";"33";"25";"0";"Sweden";"Gender"
"66";"18670";"2020";"20";"48";"24";"24";"0";"Sweden";"Gender"
"67";"18670";"2020";"20";"52";"22";"30";"0";"Sweden";"Gender"
"68";"18670";"2020";"21";"59";"30";"29";"0";"Sweden";"Gender"
"69";"18670";"2020";"21";"41";"22";"19";"0";"Sweden";"Gender"
"70";"18670";"2020";"21";"52";"32";"20";"0";"Sweden";"Gender"
"71";"18670";"2020";"21";"53";"29";"24";"0";"Sweden";"Gender"
"72";"18670";"2020";"21";"56";"27";"29";"0";"Sweden";"Gender"
"73";"18670";"2020";"21";"55";"33";"22";"0";"Sweden";"Gender"
"74";"18670";"2020";"21";"44";"25";"19";"0";"Sweden";"Gender"
"75";"18670";"2020";"22";"42";"22";"20";"0";"Sweden";"Gender"
"76";"18670";"2020";"22";"28";"18";"10";"0";"Sweden";"Gender"
"77";"18670";"2020";"22";"38";"14";"24";"0";"Sweden";"Gender"
"78";"18670";"2020";"22";"40";"18";"22";"0";"Sweden";"Gender"
"79";"18670";"2020";"22";"40";"17";"23";"0";"Sweden";"Gender"
"80";"18670";"2020";"22";"38";"20";"18";"0";"Sweden";"Gender"
"81";"18670";"2020";"22";"46";"26";"20";"0";"Sweden";"Gender"
"82";"18670";"2020";"23";"39";"20";"19";"0";"Sweden";"Gender"
"83";"18670";"2020";"23";"36";"24";"12";"0";"Sweden";"Gender"
"84";"18670";"2020";"23";"28";"15";"13";"0";"Sweden";"Gender"
"85";"18670";"2020";"23";"43";"22";"21";"0";"Sweden";"Gender"
"86";"18670";"2020";"23";"37";"23";"14";"0";"Sweden";"Gender"
"87";"18670";"2020";"23";"29";"16";"13";"0";"Sweden";"Gender"
"88";"18670";"2020";"23";"33";"22";"11";"0";"Sweden";"Gender"
"89";"18670";"2020";"24";"38";"22";"16";"0";"Sweden";"Gender"
"90";"18670";"2020";"24";"33";"18";"15";"0";"Sweden";"Gender"
"91";"18670";"2020";"24";"39";"19";"20";"0";"Sweden";"Gender"
"92";"18670";"2020";"24";"35";"19";"16";"0";"Sweden";"Gender"
"93";"18670";"2020";"24";"29";"16";"13";"0";"Sweden";"Gender"
"94";"18670";"2020";"24";"33";"16";"17";"0";"Sweden";"Gender"
"95";"18670";"2020";"24";"27";"11";"16";"0";"Sweden";"Gender"
"96";"18670";"2020";"25";"30";"17";"13";"0";"Sweden";"Gender"
"97";"18670";"2020";"25";"28";"14";"14";"0";"Sweden";"Gender"
"98";"18670";"2020";"25";"32";"16";"16";"0";"Sweden";"Gender"
"99";"18670";"2020";"25";"29";"16";"13";"0";"Sweden";"Gender"
"100";"18670";"2020";"25";"30";"16";"14";"0";"Sweden";"Gender"
"101";"18670";"2020";"25";"29";"18";"11";"0";"Sweden";"Gender"
"102";"18670";"2020";"25";"22";"11";"11";"0";"Sweden";"Gender"
"103";"18670";"2020";"26";"20";"9";"11";"0";"Sweden";"Gender"
"104";"18670";"2020";"26";"25";"12";"13";"0";"Sweden";"Gender"
"105";"18670";"2020";"26";"22";"12";"10";"0";"Sweden";"Gender"
"106";"18670";"2020";"26";"23";"12";"11";"0";"Sweden";"Gender"
"107";"18670";"2020";"26";"11";"6";"5";"0";"Sweden";"Gender"
"108";"18670";"2020";"26";"14";"9";"5";"0";"Sweden";"Gender"
"109";"18670";"2020";"26";"23";"12";"11";"0";"Sweden";"Gender"
"110";"18670";"2020";"27";"16";"11";"5";"0";"Sweden";"Gender"
"111";"18670";"2020";"27";"20";"14";"6";"0";"Sweden";"Gender"
"112";"18670";"2020";"27";"15";"9";"6";"0";"Sweden";"Gender"
"113";"18670";"2020";"27";"15";"7";"8";"0";"Sweden";"Gender"
"114";"18670";"2020";"27";"8";"3";"5";"0";"Sweden";"Gender"
"115";"18670";"2020";"27";"15";"8";"7";"0";"Sweden";"Gender"
"116";"18670";"2020";"27";"9";"5";"4";"0";"Sweden";"Gender"
"117";"18670";"2020";"28";"15";"10";"5";"0";"Sweden";"Gender"
"118";"18670";"2020";"28";"12";"7";"5";"0";"Sweden";"Gender"
"119";"18670";"2020";"28";"10";"3";"7";"0";"Sweden";"Gender"
"120";"18670";"2020";"28";"15";"7";"8";"0";"Sweden";"Gender"
"121";"18670";"2020";"28";"14";"6";"8";"0";"Sweden";"Gender"
"122";"18670";"2020";"28";"10";"5";"5";"0";"Sweden";"Gender"
"123";"18670";"2020";"28";"8";"3";"5";"0";"Sweden";"Gender"
"124";"18670";"2020";"29";"12";"10";"2";"0";"Sweden";"Gender"
"125";"18670";"2020";"29";"8";"4";"4";"0";"Sweden";"Gender"
"126";"18670";"2020";"29";"6";"2";"4";"0";"Sweden";"Gender"
"127";"18670";"2020";"29";"6";"4";"2";"0";"Sweden";"Gender"
"128";"18670";"2020";"29";"7";"4";"3";"0";"Sweden";"Gender"
"129";"18670";"2020";"29";"11";"6";"5";"0";"Sweden";"Gender"
"130";"18670";"2020";"29";"7";"3";"4";"0";"Sweden";"Gender"
"131";"18670";"2020";"30";"6";"2";"4";"0";"Sweden";"Gender"
"132";"18670";"2020";"30";"7";"3";"4";"0";"Sweden";"Gender"
"133";"18670";"2020";"30";"6";"4";"2";"0";"Sweden";"Gender"
"134";"18670";"2020";"30";"5";"3";"2";"0";"Sweden";"Gender"
"135";"18670";"2020";"30";"3";"2";"1";"0";"Sweden";"Gender"
"136";"18670";"2020";"30";"1";"1";"0";"0";"Sweden";"Gender"
"137";"18670";"2020";"30";"2";"2";"0";"0";"Sweden";"Gender"
"138";"18670";"2020";"31";"6";"3";"3";"0";"Sweden";"Gender"
"139";"18670";"2020";"31";"4";"1";"3";"0";"Sweden";"Gender"
"140";"18670";"2020";"31";"1";"0";"1";"0";"Sweden";"Gender"
"141";"18670";"2020";"31";"2";"1";"1";"0";"Sweden";"Gender"
"142";"18670";"2020";"31";"2";"2";"0";"0";"Sweden";"Gender"
"143";"18670";"2020";"31";"3";"3";"0";"0";"Sweden";"Gender"
"144";"18670";"2020";"32";"4";"1";"3";"0";"Sweden";"Gender"
"145";"18670";"2020";"32";"2";"1";"1";"0";"Sweden";"Gender"
"146";"18670";"2020";"32";"1";"0";"1";"0";"Sweden";"Gender"
"147";"18670";"2020";"32";"4";"2";"2";"0";"Sweden";"Gender"
"148";"18670";"2020";"32";"2";"2";"0";"0";"Sweden";"Gender"
"149";"18670";"2020";"32";"1";"0";"1";"0";"Sweden";"Gender"
"150";"18670";"2020";"32";"4";"4";"0";"0";"Sweden";"Gender"
"151";"18670";"2020";"33";"2";"2";"0";"0";"Sweden";"Gender"
"152";"18670";"2020";"33";"4";"0";"4";"0";"Sweden";"Gender"
"153";"18670";"2020";"33";"3";"2";"1";"0";"Sweden";"Gender"
"154";"18670";"2020";"33";"5";"4";"1";"0";"Sweden";"Gender"
"155";"18670";"2020";"33";"1";"1";"0";"0";"Sweden";"Gender"
"156";"18670";"2020";"33";"1";"0";"1";"0";"Sweden";"Gender"
"157";"18670";"2020";"34";"3";"1";"2";"0";"Sweden";"Gender"
"158";"18670";"2020";"34";"4";"3";"1";"0";"Sweden";"Gender"
"159";"18670";"2020";"34";"1";"0";"1";"0";"Sweden";"Gender"
"160";"18670";"2020";"34";"2";"1";"1";"0";"Sweden";"Gender"
"161";"18670";"2020";"34";"5";"5";"0";"0";"Sweden";"Gender"
"162";"18670";"2020";"34";"1";"0";"1";"0";"Sweden";"Gender"
"163";"18670";"2020";"34";"3";"2";"1";"0";"Sweden";"Gender"
"164";"18670";"2020";"35";"1";"1";"0";"0";"Sweden";"Gender"
"165";"18670";"2020";"35";"1";"1";"0";"0";"Sweden";"Gender"
"166";"18670";"2020";"35";"2";"0";"2";"0";"Sweden";"Gender"
"167";"18670";"2020";"35";"1";"1";"0";"0";"Sweden";"Gender"
"168";"18670";"2020";"35";"1";"1";"0";"0";"Sweden";"Gender"
"169";"18670";"2020";"35";"1";"1";"0";"0";"Sweden";"Gender"
"170";"18670";"2020";"35";"3";"0";"3";"0";"Sweden";"Gender"
"171";"18670";"2020";"36";"2";"1";"1";"0";"Sweden";"Gender"
"172";"18670";"2020";"36";"3";"1";"2";"0";"Sweden";"Gender"
"173";"18670";"2020";"36";"2";"0";"2";"0";"Sweden";"Gender"
"174";"18670";"2020";"36";"2";"1";"1";"0";"Sweden";"Gender"
"175";"18670";"2020";"36";"3";"0";"3";"0";"Sweden";"Gender"
"176";"18670";"2020";"37";"1";"0";"1";"0";"Sweden";"Gender"
"177";"18670";"2020";"37";"1";"0";"1";"0";"Sweden";"Gender"
"178";"18670";"2020";"37";"2";"2";"0";"0";"Sweden";"Gender"
"179";"18670";"2020";"37";"2";"0";"2";"0";"Sweden";"Gender"
"180";"18670";"2020";"37";"4";"3";"1";"0";"Sweden";"Gender"
"181";"18670";"2020";"37";"1";"1";"0";"0";"Sweden";"Gender"
"182";"18670";"2020";"37";"2";"1";"1";"0";"Sweden";"Gender"
"183";"18670";"2020";"38";"2";"2";"0";"0";"Sweden";"Gender"
"184";"18670";"2020";"38";"1";"1";"0";"0";"Sweden";"Gender"
"185";"18670";"2020";"38";"2";"2";"0";"0";"Sweden";"Gender"
"186";"18670";"2020";"38";"1";"1";"0";"0";"Sweden";"Gender"
"187";"18670";"2020";"38";"1";"0";"1";"0";"Sweden";"Gender"
"188";"18670";"2020";"38";"1";"1";"0";"0";"Sweden";"Gender"
"189";"18670";"2020";"38";"4";"2";"2";"0";"Sweden";"Gender"
"190";"18670";"2020";"39";"2";"1";"1";"0";"Sweden";"Gender"
"191";"18670";"2020";"39";"1";"0";"1";"0";"Sweden";"Gender"
"192";"18670";"2020";"39";"1";"1";"0";"0";"Sweden";"Gender"
"193";"18670";"2020";"39";"4";"2";"2";"0";"Sweden";"Gender"
"194";"18670";"2020";"39";"2";"1";"1";"0";"Sweden";"Gender"
"195";"18670";"2020";"39";"1";"1";"0";"0";"Sweden";"Gender"
"196";"18670";"2020";"40";"1";"1";"0";"0";"Sweden";"Gender"
"197";"18670";"2020";"40";"2";"1";"1";"0";"Sweden";"Gender"
"198";"18670";"2020";"40";"4";"4";"0";"0";"Sweden";"Gender"
"199";"18670";"2020";"40";"1";"1";"0";"0";"Sweden";"Gender"
"200";"18670";"2020";"40";"3";"2";"1";"0";"Sweden";"Gender"
"201";"18670";"2020";"40";"3";"2";"1";"0";"Sweden";"Gender"
"202";"18670";"2020";"40";"3";"2";"1";"0";"Sweden";"Gender"
"203";"18670";"2020";"41";"2";"0";"2";"0";"Sweden";"Gender"
"204";"18670";"2020";"41";"4";"3";"1";"0";"Sweden";"Gender"
"205";"18670";"2020";"41";"3";"3";"0";"0";"Sweden";"Gender"
"206";"18670";"2020";"41";"1";"1";"0";"0";"Sweden";"Gender"
"207";"18670";"2020";"41";"5";"4";"1";"0";"Sweden";"Gender"
"208";"18670";"2020";"41";"5";"4";"1";"0";"Sweden";"Gender"
"209";"18670";"2020";"41";"2";"1";"1";"0";"Sweden";"Gender"
"210";"18670";"2020";"42";"3";"2";"1";"0";"Sweden";"Gender"
"211";"18670";"2020";"42";"1";"0";"1";"0";"Sweden";"Gender"
"212";"18670";"2020";"42";"2";"2";"0";"0";"Sweden";"Gender"
"213";"18670";"2020";"42";"3";"2";"1";"0";"Sweden";"Gender"
"214";"18670";"2020";"42";"2";"1";"1";"0";"Sweden";"Gender"
"215";"18670";"2020";"42";"4";"2";"2";"0";"Sweden";"Gender"
"216";"18670";"2020";"42";"1";"0";"1";"0";"Sweden";"Gender"
"217";"18670";"2020";"43";"4";"1";"3";"0";"Sweden";"Gender"
"218";"18670";"2020";"43";"4";"3";"1";"0";"Sweden";"Gender"
"219";"18670";"2020";"43";"3";"3";"0";"0";"Sweden";"Gender"
"220";"18670";"2020";"43";"9";"4";"5";"0";"Sweden";"Gender"
"221";"18670";"2020";"43";"7";"4";"3";"0";"Sweden";"Gender"
"222";"18670";"2020";"43";"8";"7";"1";"0";"Sweden";"Gender"
"223";"18670";"2020";"43";"8";"2";"6";"0";"Sweden";"Gender"
"224";"18670";"2020";"44";"11";"6";"5";"0";"Sweden";"Gender"
"225";"18670";"2020";"44";"9";"4";"5";"0";"Sweden";"Gender"
"226";"18670";"2020";"44";"9";"7";"2";"0";"Sweden";"Gender"
"227";"18670";"2020";"44";"9";"6";"3";"0";"Sweden";"Gender"
"228";"18670";"2020";"44";"9";"4";"5";"0";"Sweden";"Gender"
"229";"18670";"2020";"44";"13";"7";"6";"0";"Sweden";"Gender"
"230";"18670";"2020";"44";"22";"10";"12";"0";"Sweden";"Gender"
"231";"18670";"2020";"45";"20";"12";"8";"0";"Sweden";"Gender"
"232";"18670";"2020";"45";"20";"12";"8";"0";"Sweden";"Gender"
"233";"18670";"2020";"45";"21";"11";"10";"0";"Sweden";"Gender"
"234";"18670";"2020";"45";"22";"14";"8";"0";"Sweden";"Gender"
"235";"18670";"2020";"45";"25";"15";"10";"0";"Sweden";"Gender"
"236";"18670";"2020";"45";"27";"14";"13";"0";"Sweden";"Gender"
"237";"18670";"2020";"45";"22";"15";"7";"0";"Sweden";"Gender"
"238";"18670";"2020";"46";"35";"14";"21";"0";"Sweden";"Gender"
"239";"18670";"2020";"46";"35";"24";"11";"0";"Sweden";"Gender"
"240";"18670";"2020";"46";"27";"12";"15";"0";"Sweden";"Gender"
"241";"18670";"2020";"46";"28";"12";"16";"0";"Sweden";"Gender"
"242";"18670";"2020";"46";"33";"14";"19";"0";"Sweden";"Gender"
"243";"18670";"2020";"46";"38";"18";"20";"0";"Sweden";"Gender"
"244";"18670";"2020";"46";"39";"18";"21";"0";"Sweden";"Gender"
"245";"18670";"2020";"47";"37";"19";"18";"0";"Sweden";"Gender"
"246";"18670";"2020";"47";"44";"26";"18";"0";"Sweden";"Gender"
"247";"18670";"2020";"47";"50";"27";"23";"0";"Sweden";"Gender"
"248";"18670";"2020";"47";"46";"25";"21";"0";"Sweden";"Gender"
"249";"18670";"2020";"47";"45";"21";"24";"0";"Sweden";"Gender"
"250";"18670";"2020";"47";"51";"19";"32";"0";"Sweden";"Gender"
"251";"18670";"2020";"47";"59";"33";"26";"0";"Sweden";"Gender"
"252";"18670";"2020";"48";"55";"29";"26";"0";"Sweden";"Gender"
"253";"18670";"2020";"48";"68";"38";"30";"0";"Sweden";"Gender"
"254";"18670";"2020";"48";"69";"27";"42";"0";"Sweden";"Gender"
"255";"18670";"2020";"48";"60";"34";"26";"0";"Sweden";"Gender"
"256";"18670";"2020";"48";"65";"34";"31";"0";"Sweden";"Gender"
"257";"18670";"2020";"48";"50";"22";"28";"0";"Sweden";"Gender"
"258";"18670";"2020";"48";"50";"24";"26";"0";"Sweden";"Gender"
"259";"18670";"2020";"49";"67";"40";"27";"0";"Sweden";"Gender"
"260";"18670";"2020";"49";"67";"36";"31";"0";"Sweden";"Gender"
"261";"18670";"2020";"49";"71";"37";"34";"0";"Sweden";"Gender"
"262";"18670";"2020";"49";"77";"37";"40";"0";"Sweden";"Gender"
"263";"18670";"2020";"49";"70";"37";"33";"0";"Sweden";"Gender"
"264";"18670";"2020";"49";"43";"27";"16";"0";"Sweden";"Gender"
"265";"18670";"2020";"49";"81";"42";"39";"0";"Sweden";"Gender"
"266";"18670";"2020";"50";"59";"24";"35";"0";"Sweden";"Gender"
"267";"18670";"2020";"50";"54";"32";"22";"0";"Sweden";"Gender"
"268";"18670";"2020";"50";"75";"41";"34";"0";"Sweden";"Gender"
"269";"18670";"2020";"50";"86";"41";"45";"0";"Sweden";"Gender"
"270";"18670";"2020";"50";"88";"47";"41";"0";"Sweden";"Gender"
"271";"18670";"2020";"50";"67";"30";"37";"0";"Sweden";"Gender"
"272";"18670";"2020";"50";"71";"36";"35";"0";"Sweden";"Gender"
"273";"18670";"2020";"51";"94";"41";"53";"0";"Sweden";"Gender"
"274";"18670";"2020";"51";"88";"47";"41";"0";"Sweden";"Gender"
"275";"18670";"2020";"51";"102";"46";"56";"0";"Sweden";"Gender"
"276";"18670";"2020";"51";"117";"65";"52";"0";"Sweden";"Gender"
"277";"18670";"2020";"51";"71";"37";"34";"0";"Sweden";"Gender"
"278";"18670";"2020";"51";"80";"41";"39";"0";"Sweden";"Gender"
"279";"18670";"2020";"51";"92";"48";"44";"0";"Sweden";"Gender"
"280";"18670";"2020";"52";"77";"43";"34";"0";"Sweden";"Gender"
"281";"18670";"2020";"52";"92";"50";"42";"0";"Sweden";"Gender"
"282";"18670";"2020";"52";"87";"55";"32";"0";"Sweden";"Gender"
"283";"18670";"2020";"52";"88";"50";"38";"0";"Sweden";"Gender"
"284";"18670";"2020";"52";"106";"64";"42";"0";"Sweden";"Gender"
"285";"18670";"2020";"52";"94";"56";"38";"0";"Sweden";"Gender"
"286";"18670";"2020";"52";"98";"57";"41";"0";"Sweden";"Gender"
"287";"18670";"2020";"53";"121";"58";"63";"0";"Sweden";"Gender"
"288";"18670";"2020";"53";"73";"30";"43";"0";"Sweden";"Gender"
"289";"18670";"2020";"53";"90";"39";"51";"0";"Sweden";"Gender"
"290";"18670";"2020";"53";"110";"54";"56";"0";"Sweden";"Gender"
"291";"18670";"2021";"53";"86";"46";"40";"0";"Sweden";"Gender"
"292";"18670";"2021";"53";"99";"49";"50";"0";"Sweden";"Gender"
"293";"18670";"2021";"53";"83";"49";"34";"0";"Sweden";"Gender"
"294";"18670";"2021";"01";"86";"45";"41";"0";"Sweden";"Gender"
"295";"18670";"2021";"01";"93";"51";"42";"0";"Sweden";"Gender"
"296";"18670";"2021";"01";"82";"49";"33";"0";"Sweden";"Gender"
"297";"18670";"2021";"01";"102";"49";"53";"0";"Sweden";"Gender"
"298";"18670";"2021";"01";"99";"42";"57";"0";"Sweden";"Gender"
"299";"18670";"2021";"01";"88";"47";"41";"0";"Sweden";"Gender"
"300";"18670";"2021";"01";"91";"49";"42";"0";"Sweden";"Gender"
"301";"18670";"2021";"02";"89";"46";"43";"0";"Sweden";"Gender"
"302";"18670";"2021";"02";"88";"47";"41";"0";"Sweden";"Gender"
"303";"18670";"2021";"02";"90";"49";"41";"0";"Sweden";"Gender"
"304";"18670";"2021";"02";"95";"53";"42";"0";"Sweden";"Gender"
"305";"18670";"2021";"02";"87";"56";"31";"0";"Sweden";"Gender"
"306";"18670";"2021";"02";"82";"45";"37";"0";"Sweden";"Gender"
"307";"18670";"2021";"02";"60";"33";"27";"0";"Sweden";"Gender"
"308";"18670";"2021";"03";"73";"37";"36";"0";"Sweden";"Gender"
"309";"18670";"2021";"03";"89";"51";"38";"0";"Sweden";"Gender"
"310";"18670";"2021";"03";"87";"39";"48";"0";"Sweden";"Gender"
"311";"18670";"2021";"03";"88";"48";"40";"0";"Sweden";"Gender"
"312";"18670";"2021";"03";"60";"32";"28";"0";"Sweden";"Gender"
"313";"18670";"2021";"03";"62";"28";"34";"0";"Sweden";"Gender"
"314";"18670";"2021";"03";"52";"29";"23";"0";"Sweden";"Gender"
"315";"18670";"2021";"04";"56";"31";"25";"0";"Sweden";"Gender"
"316";"18670";"2021";"04";"65";"31";"34";"0";"Sweden";"Gender"
"317";"18670";"2021";"04";"53";"24";"29";"0";"Sweden";"Gender"
"318";"18670";"2021";"04";"51";"32";"19";"0";"Sweden";"Gender"
"319";"18670";"2021";"04";"54";"31";"23";"0";"Sweden";"Gender"
"320";"18670";"2021";"04";"55";"24";"31";"0";"Sweden";"Gender"
"321";"18670";"2021";"04";"38";"14";"24";"0";"Sweden";"Gender"
"322";"18670";"2021";"05";"43";"27";"16";"0";"Sweden";"Gender"
"323";"18670";"2021";"05";"42";"25";"17";"0";"Sweden";"Gender"
"324";"18670";"2021";"05";"42";"27";"15";"0";"Sweden";"Gender"
"325";"18670";"2021";"05";"23";"12";"11";"0";"Sweden";"Gender"
"326";"18670";"2021";"05";"15";"9";"6";"0";"Sweden";"Gender"
"327";"18670";"2021";"05";"21";"13";"8";"0";"Sweden";"Gender"
"328";"18670";"2021";"05";"20";"10";"10";"0";"Sweden";"Gender"
"329";"18670";"2021";"06";"20";"9";"11";"0";"Sweden";"Gender"
"330";"18670";"2021";"06";"9";"5";"4";"0";"Sweden";"Gender"
"331";"18670";"2021";"06";"6";"4";"2";"0";"Sweden";"Gender"
"332";"18670";"2021";"06";"4";"0";"4";"0";"Sweden";"Gender"
"333";"18670";"2021";"06";"4";"1";"3";"0";"Sweden";"Gender"
