"";"date";"Year";"WeekNo";"total_covid_death";"male_covid_death";"female_covid_death";"NC_covid_death";"country";"Type"
"1";"2020-03-26";"2020";"13";"38";"32";"6";"0";"Switzerland";"Gender"
"2";"2020-04-10";"2020";"15";"52";"28";"24";"0";"Switzerland";"Gender"
"3";"2020-10-28";"2020";"44";"42";"25";"17";"0";"Switzerland";"Gender"
"4";"2020-11-14";"2020";"46";"77";"38";"39";"0";"Switzerland";"Gender"
"5";"2021-02-08";"2021";"06";"19";"12";"7";"0";"Switzerland";"Gender"
"6";"2020-03-12";"2020";"11";"4";"2";"2";"0";"Switzerland";"Gender"
"7";"2020-12-10";"2020";"50";"84";"41";"43";"0";"Switzerland";"Gender"
"8";"2020-11-29";"2020";"48";"81";"48";"33";"0";"Switzerland";"Gender"
"9";"2020-11-05";"2020";"45";"78";"44";"34";"0";"Switzerland";"Gender"
"10";"2020-11-04";"2020";"45";"82";"52";"30";"0";"Switzerland";"Gender"
"11";"2020-04-03";"2020";"14";"57";"31";"26";"0";"Switzerland";"Gender"
"12";"2020-12-30";"2020";"53";"90";"41";"49";"0";"Switzerland";"Gender"
"13";"2020-11-27";"2020";"48";"88";"50";"38";"0";"Switzerland";"Gender"
"14";"2021-01-07";"2021";"01";"62";"32";"30";"0";"Switzerland";"Gender"
"15";"2020-11-16";"2020";"47";"91";"57";"34";"0";"Switzerland";"Gender"
"16";"2021-01-21";"2021";"03";"42";"21";"21";"0";"Switzerland";"Gender"
"17";"2020-11-20";"2020";"47";"81";"42";"39";"0";"Switzerland";"Gender"
"18";"2020-10-26";"2020";"44";"20";"9";"11";"0";"Switzerland";"Gender"
"19";"2020-11-26";"2020";"48";"73";"33";"40";"0";"Switzerland";"Gender"
"20";"2020-12-19";"2020";"51";"79";"45";"34";"0";"Switzerland";"Gender"
"21";"2020-05-01";"2020";"18";"12";"7";"5";"0";"Switzerland";"Gender"
"22";"2021-02-05";"2021";"05";"22";"10";"12";"0";"Switzerland";"Gender"
"23";"2021-01-24";"2021";"03";"47";"20";"27";"0";"Switzerland";"Gender"
"24";"2020-04-20";"2020";"17";"38";"20";"18";"0";"Switzerland";"Gender"
"25";"2021-01-01";"2021";"53";"73";"36";"37";"0";"Switzerland";"Gender"
"26";"2021-01-05";"2021";"01";"64";"39";"25";"0";"Switzerland";"Gender"
"27";"2020-11-19";"2020";"47";"79";"38";"41";"0";"Switzerland";"Gender"
"28";"2020-10-29";"2020";"44";"58";"34";"24";"0";"Switzerland";"Gender"
"29";"2020-12-06";"2020";"49";"65";"30";"35";"0";"Switzerland";"Gender"
"30";"2020-12-28";"2020";"53";"76";"37";"39";"0";"Switzerland";"Gender"
"31";"2020-12-13";"2020";"50";"84";"48";"36";"0";"Switzerland";"Gender"
"32";"2020-04-08";"2020";"15";"58";"29";"29";"0";"Switzerland";"Gender"
"33";"2020-12-26";"2020";"52";"92";"49";"43";"0";"Switzerland";"Gender"
"34";"2020-11-28";"2020";"48";"87";"52";"35";"0";"Switzerland";"Gender"
"35";"2021-01-20";"2021";"03";"43";"20";"23";"0";"Switzerland";"Gender"
"36";"2020-11-03";"2020";"45";"79";"43";"36";"0";"Switzerland";"Gender"
"37";"2020-11-30";"2020";"49";"91";"41";"50";"0";"Switzerland";"Gender"
"38";"2020-11-21";"2020";"47";"77";"44";"33";"0";"Switzerland";"Gender"
"39";"2020-11-09";"2020";"46";"85";"38";"47";"0";"Switzerland";"Gender"
"40";"2020-12-22";"2020";"52";"83";"43";"40";"0";"Switzerland";"Gender"
"41";"2020-11-22";"2020";"47";"79";"42";"37";"0";"Switzerland";"Gender"
"42";"2020-04-06";"2020";"15";"50";"28";"22";"0";"Switzerland";"Gender"
"43";"2021-01-10";"2021";"01";"55";"26";"29";"0";"Switzerland";"Gender"
"44";"2020-12-11";"2020";"50";"87";"44";"43";"0";"Switzerland";"Gender"
"45";"2020-03-30";"2020";"14";"58";"41";"17";"0";"Switzerland";"Gender"
"46";"2020-12-07";"2020";"50";"77";"35";"42";"0";"Switzerland";"Gender"
"47";"2021-01-02";"2021";"53";"64";"31";"33";"0";"Switzerland";"Gender"
"48";"2020-11-06";"2020";"45";"92";"54";"38";"0";"Switzerland";"Gender"
"49";"2020-03-28";"2020";"13";"57";"38";"19";"0";"Switzerland";"Gender"
"50";"2020-12-05";"2020";"49";"95";"48";"47";"0";"Switzerland";"Gender"
"51";"2021-01-16";"2021";"02";"48";"29";"19";"0";"Switzerland";"Gender"
"52";"2020-11-25";"2020";"48";"85";"46";"39";"0";"Switzerland";"Gender"
"53";"2021-01-09";"2021";"01";"62";"37";"25";"0";"Switzerland";"Gender"
"54";"2020-12-27";"2020";"52";"92";"47";"45";"0";"Switzerland";"Gender"
"55";"2020-11-13";"2020";"46";"85";"35";"50";"0";"Switzerland";"Gender"
"56";"2020-11-10";"2020";"46";"83";"47";"36";"0";"Switzerland";"Gender"
"57";"2020-12-03";"2020";"49";"79";"50";"29";"0";"Switzerland";"Gender"
"58";"2021-01-29";"2021";"04";"30";"16";"14";"0";"Switzerland";"Gender"
"59";"2021-02-14";"2021";"06";"20";"12";"8";"0";"Switzerland";"Gender"
"60";"2021-02-04";"2021";"05";"20";"9";"11";"0";"Switzerland";"Gender"
"61";"2021-02-22";"2021";"08";"6";"2";"4";"0";"Switzerland";"Gender"
"62";"2020-10-25";"2020";"43";"21";"8";"13";"0";"Switzerland";"Gender"
"63";"2020-12-17";"2020";"51";"84";"40";"44";"0";"Switzerland";"Gender"
"64";"2020-03-24";"2020";"13";"19";"12";"7";"0";"Switzerland";"Gender"
"65";"2020-04-02";"2020";"14";"60";"41";"19";"0";"Switzerland";"Gender"
"66";"2020-12-14";"2020";"51";"97";"50";"47";"0";"Switzerland";"Gender"
"67";"2020-11-15";"2020";"46";"85";"43";"42";"0";"Switzerland";"Gender"
"68";"2020-04-21";"2020";"17";"33";"22";"11";"0";"Switzerland";"Gender"
"69";"2020-12-02";"2020";"49";"88";"38";"50";"0";"Switzerland";"Gender"
"70";"2021-01-17";"2021";"02";"32";"20";"12";"0";"Switzerland";"Gender"
"71";"2020-04-11";"2020";"15";"45";"26";"19";"0";"Switzerland";"Gender"
"72";"2020-12-15";"2020";"51";"88";"35";"53";"0";"Switzerland";"Gender"
"73";"2021-01-26";"2021";"04";"35";"22";"13";"0";"Switzerland";"Gender"
"74";"2020-12-12";"2020";"50";"84";"41";"43";"0";"Switzerland";"Gender"
"75";"2020-11-23";"2020";"48";"96";"52";"44";"0";"Switzerland";"Gender"
"76";"2020-12-09";"2020";"50";"81";"43";"38";"0";"Switzerland";"Gender"
"77";"2020-11-08";"2020";"45";"89";"49";"40";"0";"Switzerland";"Gender"
"78";"2021-01-19";"2021";"03";"62";"32";"30";"0";"Switzerland";"Gender"
"79";"2021-01-14";"2021";"02";"47";"27";"20";"0";"Switzerland";"Gender"
"80";"2020-11-24";"2020";"48";"90";"47";"43";"0";"Switzerland";"Gender"
"81";"2021-02-12";"2021";"06";"16";"6";"10";"0";"Switzerland";"Gender"
"82";"2020-10-31";"2020";"44";"59";"39";"20";"0";"Switzerland";"Gender"
"83";"2021-01-13";"2021";"02";"56";"28";"28";"0";"Switzerland";"Gender"
"84";"2020-04-01";"2020";"14";"57";"32";"25";"0";"Switzerland";"Gender"
"85";"2021-01-30";"2021";"04";"27";"10";"17";"0";"Switzerland";"Gender"
"86";"2020-11-12";"2020";"46";"103";"49";"54";"0";"Switzerland";"Gender"
"87";"2020-05-10";"2020";"19";"7";"4";"3";"0";"Switzerland";"Gender"
"88";"2020-04-22";"2020";"17";"27";"12";"15";"0";"Switzerland";"Gender"
"89";"2020-03-23";"2020";"13";"23";"11";"12";"0";"Switzerland";"Gender"
"90";"2020-11-18";"2020";"47";"104";"54";"50";"0";"Switzerland";"Gender"
"91";"2020-11-07";"2020";"45";"69";"41";"28";"0";"Switzerland";"Gender"
"92";"2020-04-09";"2020";"15";"45";"23";"22";"0";"Switzerland";"Gender"
"93";"2020-12-20";"2020";"51";"100";"44";"56";"0";"Switzerland";"Gender"
"94";"2020-03-27";"2020";"13";"32";"18";"14";"0";"Switzerland";"Gender"
"95";"2021-01-11";"2021";"02";"55";"33";"22";"0";"Switzerland";"Gender"
"96";"2020-03-25";"2020";"13";"39";"26";"13";"0";"Switzerland";"Gender"
"97";"2020-10-27";"2020";"44";"39";"20";"19";"0";"Switzerland";"Gender"
"98";"2020-12-08";"2020";"50";"94";"54";"40";"0";"Switzerland";"Gender"
"99";"2020-03-29";"2020";"13";"46";"32";"14";"0";"Switzerland";"Gender"
"100";"2020-11-02";"2020";"45";"59";"28";"31";"0";"Switzerland";"Gender"
"101";"2020-11-11";"2020";"46";"89";"52";"37";"0";"Switzerland";"Gender"
"102";"2021-02-06";"2021";"05";"24";"12";"12";"0";"Switzerland";"Gender"
"103";"2020-04-27";"2020";"18";"23";"14";"9";"0";"Switzerland";"Gender"
"104";"2020-03-16";"2020";"12";"7";"6";"1";"0";"Switzerland";"Gender"
"105";"2020-12-21";"2020";"52";"88";"44";"44";"0";"Switzerland";"Gender"
"106";"2020-03-19";"2020";"12";"14";"9";"5";"0";"Switzerland";"Gender"
"107";"2020-04-05";"2020";"14";"50";"31";"19";"0";"Switzerland";"Gender"
"108";"2020-09-28";"2020";"40";"3";"3";"0";"0";"Switzerland";"Gender"
"109";"2020-04-23";"2020";"17";"31";"12";"19";"0";"Switzerland";"Gender"
"110";"2020-10-18";"2020";"42";"7";"4";"3";"0";"Switzerland";"Gender"
"111";"2021-02-24";"2021";"08";"5";"3";"2";"0";"Switzerland";"Gender"
"112";"2021-01-03";"2021";"53";"65";"40";"25";"0";"Switzerland";"Gender"
"113";"2020-12-23";"2020";"52";"80";"40";"40";"0";"Switzerland";"Gender"
"114";"2020-04-18";"2020";"16";"34";"13";"21";"0";"Switzerland";"Gender"
"115";"2020-12-16";"2020";"51";"89";"48";"41";"0";"Switzerland";"Gender"
"116";"2020-04-12";"2020";"15";"36";"15";"21";"0";"Switzerland";"Gender"
"117";"2020-04-24";"2020";"17";"27";"13";"14";"0";"Switzerland";"Gender"
"118";"2020-12-04";"2020";"49";"80";"44";"36";"0";"Switzerland";"Gender"
"119";"2020-12-24";"2020";"52";"91";"40";"51";"0";"Switzerland";"Gender"
"120";"2020-04-13";"2020";"16";"36";"17";"19";"0";"Switzerland";"Gender"
"121";"2021-02-10";"2021";"06";"20";"13";"7";"0";"Switzerland";"Gender"
"122";"2020-10-21";"2020";"43";"18";"8";"10";"0";"Switzerland";"Gender"
"123";"2020-04-07";"2020";"15";"57";"34";"23";"0";"Switzerland";"Gender"
"124";"2021-01-25";"2021";"04";"30";"19";"11";"0";"Switzerland";"Gender"
"125";"2021-01-04";"2021";"01";"50";"32";"18";"0";"Switzerland";"Gender"
"126";"2020-04-15";"2020";"16";"38";"25";"13";"0";"Switzerland";"Gender"
"127";"2020-05-07";"2020";"19";"12";"7";"5";"0";"Switzerland";"Gender"
"128";"2021-02-09";"2021";"06";"15";"9";"6";"0";"Switzerland";"Gender"
"129";"2021-01-18";"2021";"03";"36";"18";"18";"0";"Switzerland";"Gender"
"130";"2020-11-01";"2020";"44";"59";"34";"25";"0";"Switzerland";"Gender"
"131";"2020-12-29";"2020";"53";"73";"41";"32";"0";"Switzerland";"Gender"
"132";"2021-01-06";"2021";"01";"59";"37";"22";"0";"Switzerland";"Gender"
"133";"2021-01-15";"2021";"02";"61";"38";"23";"0";"Switzerland";"Gender"
"134";"2020-12-18";"2020";"51";"91";"46";"45";"0";"Switzerland";"Gender"
"135";"2020-04-14";"2020";"16";"37";"22";"15";"0";"Switzerland";"Gender"
"136";"2020-10-30";"2020";"44";"42";"23";"19";"0";"Switzerland";"Gender"
"137";"2020-10-23";"2020";"43";"25";"13";"12";"0";"Switzerland";"Gender"
"138";"2021-02-16";"2021";"07";"8";"6";"2";"0";"Switzerland";"Gender"
"139";"2021-02-23";"2021";"08";"7";"3";"4";"0";"Switzerland";"Gender"
"140";"2020-10-14";"2020";"42";"5";"3";"2";"0";"Switzerland";"Gender"
"141";"2021-01-28";"2021";"04";"36";"20";"16";"0";"Switzerland";"Gender"
"142";"2020-11-17";"2020";"47";"86";"49";"37";"0";"Switzerland";"Gender"
"143";"2020-04-28";"2020";"18";"12";"6";"6";"0";"Switzerland";"Gender"
"144";"2020-12-31";"2020";"53";"78";"42";"36";"0";"Switzerland";"Gender"
"145";"2020-09-02";"2020";"36";"3";"2";"1";"0";"Switzerland";"Gender"
"146";"2020-04-30";"2020";"18";"14";"7";"7";"0";"Switzerland";"Gender"
"147";"2020-05-17";"2020";"20";"4";"1";"3";"0";"Switzerland";"Gender"
"148";"2020-05-06";"2020";"19";"4";"4";"0";"0";"Switzerland";"Gender"
"149";"2020-09-23";"2020";"39";"1";"1";"0";"0";"Switzerland";"Gender"
"150";"2020-12-01";"2020";"49";"88";"51";"37";"0";"Switzerland";"Gender"
"151";"2020-04-19";"2020";"16";"21";"9";"12";"0";"Switzerland";"Gender"
"152";"2021-02-02";"2021";"05";"20";"10";"10";"0";"Switzerland";"Gender"
"153";"2020-12-25";"2020";"52";"62";"36";"26";"0";"Switzerland";"Gender"
"154";"2020-03-31";"2020";"14";"44";"26";"18";"0";"Switzerland";"Gender"
"155";"2020-04-16";"2020";"16";"38";"20";"18";"0";"Switzerland";"Gender"
"156";"2020-04-26";"2020";"17";"13";"4";"9";"0";"Switzerland";"Gender"
"157";"2021-01-31";"2021";"04";"27";"15";"12";"0";"Switzerland";"Gender"
"158";"2021-02-11";"2021";"06";"13";"7";"6";"0";"Switzerland";"Gender"
"159";"2021-01-08";"2021";"01";"48";"25";"23";"0";"Switzerland";"Gender"
"160";"2020-07-27";"2020";"31";"1";"1";"0";"0";"Switzerland";"Gender"
"161";"2021-02-07";"2021";"05";"17";"5";"12";"0";"Switzerland";"Gender"
"162";"2020-04-04";"2020";"14";"56";"30";"26";"0";"Switzerland";"Gender"
"163";"2020-04-29";"2020";"18";"11";"6";"5";"0";"Switzerland";"Gender"
"164";"2020-07-08";"2020";"28";"2";"1";"1";"0";"Switzerland";"Gender"
"165";"2020-03-17";"2020";"12";"12";"7";"5";"0";"Switzerland";"Gender"
"166";"2021-02-13";"2021";"06";"17";"10";"7";"0";"Switzerland";"Gender"
"167";"2021-01-22";"2021";"03";"43";"21";"22";"0";"Switzerland";"Gender"
"168";"2020-10-04";"2020";"40";"1";"1";"0";"0";"Switzerland";"Gender"
"169";"2020-09-24";"2020";"39";"4";"3";"1";"0";"Switzerland";"Gender"
"170";"2021-01-27";"2021";"04";"32";"14";"18";"0";"Switzerland";"Gender"
"171";"2020-07-17";"2020";"29";"1";"1";"0";"0";"Switzerland";"Gender"
"172";"2020-05-08";"2020";"19";"7";"4";"3";"0";"Switzerland";"Gender"
"173";"2020-10-22";"2020";"43";"25";"12";"13";"0";"Switzerland";"Gender"
"174";"2021-02-03";"2021";"05";"19";"9";"10";"0";"Switzerland";"Gender"
"175";"2021-02-20";"2021";"07";"12";"7";"5";"0";"Switzerland";"Gender"
"176";"2021-02-01";"2021";"05";"30";"15";"15";"0";"Switzerland";"Gender"
"177";"2021-01-12";"2021";"02";"51";"25";"26";"0";"Switzerland";"Gender"
"178";"2021-01-23";"2021";"03";"44";"24";"20";"0";"Switzerland";"Gender"
"179";"2020-10-13";"2020";"42";"6";"4";"2";"0";"Switzerland";"Gender"
"180";"2020-09-17";"2020";"38";"4";"2";"2";"0";"Switzerland";"Gender"
"181";"2020-08-17";"2020";"34";"1";"0";"1";"0";"Switzerland";"Gender"
"182";"2021-02-15";"2021";"07";"15";"6";"9";"0";"Switzerland";"Gender"
"183";"2020-03-20";"2020";"12";"21";"12";"9";"0";"Switzerland";"Gender"
"184";"2020-09-05";"2020";"36";"2";"1";"1";"0";"Switzerland";"Gender"
"185";"2020-10-17";"2020";"42";"7";"3";"4";"0";"Switzerland";"Gender"
"186";"2020-08-24";"2020";"35";"1";"1";"0";"0";"Switzerland";"Gender"
"187";"2020-08-27";"2020";"35";"2";"1";"1";"0";"Switzerland";"Gender"
"188";"2020-09-26";"2020";"39";"2";"2";"0";"0";"Switzerland";"Gender"
"189";"2020-03-21";"2020";"12";"19";"12";"7";"0";"Switzerland";"Gender"
"190";"2020-10-20";"2020";"43";"12";"4";"8";"0";"Switzerland";"Gender"
"191";"2021-02-18";"2021";"07";"10";"2";"8";"0";"Switzerland";"Gender"
"192";"2020-10-15";"2020";"42";"5";"3";"2";"0";"Switzerland";"Gender"
"193";"2020-10-19";"2020";"43";"16";"12";"4";"0";"Switzerland";"Gender"
"194";"2020-05-04";"2020";"19";"9";"3";"6";"0";"Switzerland";"Gender"
"195";"2020-10-24";"2020";"43";"25";"15";"10";"0";"Switzerland";"Gender"
"196";"2020-03-18";"2020";"12";"8";"4";"4";"0";"Switzerland";"Gender"
"197";"2020-05-02";"2020";"18";"9";"5";"4";"0";"Switzerland";"Gender"
"198";"2020-08-10";"2020";"33";"1";"1";"0";"0";"Switzerland";"Gender"
"199";"2020-04-17";"2020";"16";"36";"17";"19";"0";"Switzerland";"Gender"
"200";"2020-09-29";"2020";"40";"1";"0";"1";"0";"Switzerland";"Gender"
"201";"2020-05-12";"2020";"20";"1";"1";"0";"0";"Switzerland";"Gender"
"202";"2020-07-28";"2020";"31";"1";"0";"1";"0";"Switzerland";"Gender"
"203";"2021-02-19";"2021";"07";"10";"4";"6";"0";"Switzerland";"Gender"
"204";"2020-09-08";"2020";"37";"1";"1";"0";"0";"Switzerland";"Gender"
"205";"2020-09-21";"2020";"39";"3";"3";"0";"0";"Switzerland";"Gender"
"206";"2020-03-14";"2020";"11";"5";"3";"2";"0";"Switzerland";"Gender"
"207";"2020-05-16";"2020";"20";"1";"1";"0";"0";"Switzerland";"Gender"
"208";"2020-03-22";"2020";"12";"18";"9";"9";"0";"Switzerland";"Gender"
"209";"2020-03-05";"2020";"10";"2";"1";"1";"0";"Switzerland";"Gender"
"210";"2020-04-25";"2020";"17";"25";"14";"11";"0";"Switzerland";"Gender"
"211";"2020-05-05";"2020";"19";"10";"7";"3";"0";"Switzerland";"Gender"
"212";"2020-10-01";"2020";"40";"5";"1";"4";"0";"Switzerland";"Gender"
"213";"2020-05-18";"2020";"21";"3";"3";"0";"0";"Switzerland";"Gender"
"214";"2020-09-01";"2020";"36";"1";"0";"1";"0";"Switzerland";"Gender"
"215";"2020-10-07";"2020";"41";"2";"2";"0";"0";"Switzerland";"Gender"
"216";"2021-02-25";"2021";"08";"5";"2";"3";"0";"Switzerland";"Gender"
"217";"2020-05-15";"2020";"20";"5";"4";"1";"0";"Switzerland";"Gender"
"218";"2020-03-13";"2020";"11";"3";"2";"1";"0";"Switzerland";"Gender"
"219";"2021-02-21";"2021";"07";"7";"4";"3";"0";"Switzerland";"Gender"
"220";"2020-09-16";"2020";"38";"5";"1";"4";"0";"Switzerland";"Gender"
"221";"2020-05-23";"2020";"21";"1";"0";"1";"0";"Switzerland";"Gender"
"222";"2020-10-05";"2020";"41";"2";"1";"1";"0";"Switzerland";"Gender"
"223";"2020-06-06";"2020";"23";"1";"1";"0";"0";"Switzerland";"Gender"
"224";"2020-10-12";"2020";"42";"5";"3";"2";"0";"Switzerland";"Gender"
"225";"2020-08-06";"2020";"32";"1";"1";"0";"0";"Switzerland";"Gender"
"226";"2020-09-07";"2020";"37";"1";"1";"0";"0";"Switzerland";"Gender"
"227";"2020-09-06";"2020";"36";"3";"2";"1";"0";"Switzerland";"Gender"
"228";"2020-09-09";"2020";"37";"7";"4";"3";"0";"Switzerland";"Gender"
"229";"2020-08-22";"2020";"34";"1";"0";"1";"0";"Switzerland";"Gender"
"230";"2020-07-15";"2020";"29";"1";"1";"0";"0";"Switzerland";"Gender"
"231";"2020-10-10";"2020";"41";"3";"2";"1";"0";"Switzerland";"Gender"
"232";"2020-08-23";"2020";"34";"2";"2";"0";"0";"Switzerland";"Gender"
"233";"2020-05-03";"2020";"18";"8";"5";"3";"0";"Switzerland";"Gender"
"234";"2020-05-21";"2020";"21";"5";"2";"3";"0";"Switzerland";"Gender"
"235";"2020-05-09";"2020";"19";"5";"3";"2";"0";"Switzerland";"Gender"
"236";"2020-10-02";"2020";"40";"1";"0";"1";"0";"Switzerland";"Gender"
"237";"2020-10-16";"2020";"42";"10";"4";"6";"0";"Switzerland";"Gender"
"238";"2020-10-09";"2020";"41";"3";"3";"0";"0";"Switzerland";"Gender"
"239";"2020-09-11";"2020";"37";"4";"3";"1";"0";"Switzerland";"Gender"
"240";"2020-07-01";"2020";"27";"1";"0";"1";"0";"Switzerland";"Gender"
"241";"2020-05-11";"2020";"20";"3";"2";"1";"0";"Switzerland";"Gender"
"242";"2020-03-15";"2020";"11";"8";"6";"2";"0";"Switzerland";"Gender"
"243";"2020-07-16";"2020";"29";"1";"1";"0";"0";"Switzerland";"Gender"
"244";"2020-09-27";"2020";"39";"1";"1";"0";"0";"Switzerland";"Gender"
"245";"2020-08-15";"2020";"33";"3";"2";"1";"0";"Switzerland";"Gender"
"246";"2020-10-08";"2020";"41";"3";"2";"1";"0";"Switzerland";"Gender"
"247";"2021-02-17";"2021";"07";"8";"5";"3";"0";"Switzerland";"Gender"
"248";"2020-06-16";"2020";"25";"1";"0";"1";"0";"Switzerland";"Gender"
"249";"2020-08-13";"2020";"33";"1";"1";"0";"0";"Switzerland";"Gender"
"250";"2020-08-30";"2020";"35";"1";"0";"1";"0";"Switzerland";"Gender"
"251";"2020-07-20";"2020";"30";"2";"2";"0";"0";"Switzerland";"Gender"
"252";"2020-05-19";"2020";"21";"4";"3";"1";"0";"Switzerland";"Gender"
"253";"2020-09-13";"2020";"37";"1";"1";"0";"0";"Switzerland";"Gender"
"254";"2020-05-25";"2020";"22";"2";"1";"1";"0";"Switzerland";"Gender"
"255";"2020-09-04";"2020";"36";"2";"0";"2";"0";"Switzerland";"Gender"
"256";"2020-05-14";"2020";"20";"2";"1";"1";"0";"Switzerland";"Gender"
"257";"2020-08-08";"2020";"32";"1";"0";"1";"0";"Switzerland";"Gender"
"258";"2020-03-11";"2020";"11";"3";"2";"1";"0";"Switzerland";"Gender"
"259";"2020-07-31";"2020";"31";"2";"2";"0";"0";"Switzerland";"Gender"
"260";"2020-06-29";"2020";"27";"1";"1";"0";"0";"Switzerland";"Gender"
"261";"2020-06-13";"2020";"24";"1";"1";"0";"0";"Switzerland";"Gender"
"262";"2020-08-04";"2020";"32";"1";"1";"0";"0";"Switzerland";"Gender"
"263";"2020-07-21";"2020";"30";"1";"1";"0";"0";"Switzerland";"Gender"
"264";"2020-07-25";"2020";"30";"1";"0";"1";"0";"Switzerland";"Gender"
"265";"2020-08-01";"2020";"31";"1";"1";"0";"0";"Switzerland";"Gender"
"266";"2020-07-24";"2020";"30";"1";"1";"0";"0";"Switzerland";"Gender"
"267";"2020-10-11";"2020";"41";"3";"3";"0";"0";"Switzerland";"Gender"
"268";"2020-06-22";"2020";"26";"1";"1";"0";"0";"Switzerland";"Gender"
"269";"2020-09-19";"2020";"38";"1";"1";"0";"0";"Switzerland";"Gender"
"270";"2020-09-12";"2020";"37";"3";"1";"2";"0";"Switzerland";"Gender"
"271";"2020-09-18";"2020";"38";"2";"1";"1";"0";"Switzerland";"Gender"
"272";"2020-03-10";"2020";"11";"2";"0";"2";"0";"Switzerland";"Gender"
"273";"2020-08-31";"2020";"36";"1";"0";"1";"0";"Switzerland";"Gender"
"274";"2020-05-26";"2020";"22";"2";"1";"1";"0";"Switzerland";"Gender"
"275";"2020-08-05";"2020";"32";"1";"0";"1";"0";"Switzerland";"Gender"
"276";"2020-09-25";"2020";"39";"1";"0";"1";"0";"Switzerland";"Gender"
"277";"2020-06-08";"2020";"24";"1";"1";"0";"0";"Switzerland";"Gender"
"278";"2020-09-15";"2020";"38";"3";"1";"2";"0";"Switzerland";"Gender"
"279";"2020-07-13";"2020";"29";"1";"1";"0";"0";"Switzerland";"Gender"
"280";"2020-09-03";"2020";"36";"1";"1";"0";"0";"Switzerland";"Gender"
"281";"2020-06-10";"2020";"24";"1";"1";"0";"0";"Switzerland";"Gender"
"282";"2020-08-21";"2020";"34";"1";"0";"1";"0";"Switzerland";"Gender"
"283";"2020-05-22";"2020";"21";"1";"0";"1";"0";"Switzerland";"Gender"
"284";"2020-05-13";"2020";"20";"1";"1";"0";"0";"Switzerland";"Gender"
"285";"2020-03-08";"2020";"10";"1";"1";"0";"0";"Switzerland";"Gender"
"286";"2020-06-21";"2020";"25";"1";"0";"1";"0";"Switzerland";"Gender"
"287";"2020-09-22";"2020";"39";"1";"0";"1";"0";"Switzerland";"Gender"
"288";"2020-10-06";"2020";"41";"1";"1";"0";"0";"Switzerland";"Gender"
"289";"2020-08-07";"2020";"32";"1";"1";"0";"0";"Switzerland";"Gender"
"290";"2020-06-12";"2020";"24";"1";"0";"1";"0";"Switzerland";"Gender"
